aarp=whois.nic.aarp
abb=whois.nic.abb
abbott=whois.nic.abbott
abbvie=whois.nic.abbvie
abc=whois.nic.abc
ac=whois.nic.ac
aco=whois.nic.aco
actor=whois.nic.actor
ads=whois.nic.google
adult=whois.nic.adult
ae=whois.aeda.net.ae
aeg=whois.nic.aeg
aero=whois.aero
af=whois.nic.af
afl=whois.nic.afl
africa=whois.nic.africa
ag=whois.nic.ag
agency=whois.nic.agency
ai=whois.nic.ai
airbus=whois.nic.airbus
airtel=whois.nic.airtel
akdn=whois.nic.akdn
alipay=whois.nic.alipay
ally=whois.nic.ally
alsace=whois.nic.alsace
alstom=whois.nic.alstom
am=whois.amnic.net
amazon=whois.nic.amazon
amfam=whois.nic.amfam
anquan=whois.teleinfo.cn
anz=whois.nic.anz
aol=whois.nic.aol
app=whois.nic.google
apple=whois.nic.apple
ar=whois.nic.ar
arab=whois.nic.arab
archi=whois.nic.archi
army=whois.nic.army
arpa=whois.iana.org
art=whois.nic.art
arte=whois.nic.arte
as=whois.nic.as
asda=whois.nic.asda
asia=whois.nic.asia
at=whois.nic.at
au=whois.auda.org.au
audi=whois.nic.audi
audio=whois.nic.audio
author=whois.nic.author
auto=whois.nic.auto
autos=whois.nic.autos
aw=whois.nic.aw
aws=whois.nic.aws
ax=whois.ax
baby=whois.nic.baby
baidu=whois.gtld.knet.cn
band=whois.nic.band
bank=whois.nic.bank
bar=whois.nic.bar
bayern=whois.nic.bayern
bbc=whois.nic.bbc
bbt=whois.nic.bbt
bbva=whois.nic.bbva
bcg=whois.nic.bcg
bcn=whois.nic.bcn
be=whois.dns.be
beats=whois.nic.beats
beauty=whois.nic.beauty
beer=whois.nic.beer
berlin=whois.nic.berlin
best=whois.nic.best
bet=whois.nic.bet
bf=whois.registre.bf
bg=whois.register.bg
bh=whois.nic.bh
bi=whois1.nic.bi
bible=whois.nic.bible
bid=whois.nic.bid
bike=whois.nic.bike
bingo=whois.nic.bingo
bio=whois.nic.bio
biz=whois.nic.biz
bj=whois.nic.bj
black=whois.nic.black
blog=whois.nic.blog
blue=whois.nic.blue
bms=whois.nic.bms
bmw=whois.nic.bmw
bn=whois.bnnic.bn
bo=whois.nic.bo
boats=whois.nic.boats
bofa=whois.nic.bofa
bom=whois.gtlds.nic.br
bond=whois.nic.bond
boo=whois.nic.google
book=whois.nic.book
bosch=whois.nic.bosch
bostik=whois.nic.bostik
boston=whois.nic.boston
bot=whois.nic.bot
box=whois.nic.box
br=whois.registro.br
broker=whois.nic.broker
build=whois.nic.build
buy=whois.nic.buy
buzz=whois.nic.buzz
bw=whois.nic.net.bw
by=whois.cctld.by
bzh=whois.nic.bzh
ca=whois.cira.ca
cab=whois.nic.cab
cafe=whois.nic.cafe
cal=whois.nic.google
call=whois.nic.call
cam=whois.nic.cam
camera=whois.nic.camera
camp=whois.nic.camp
canon=whois.nic.canon
car=whois.nic.car
cards=whois.nic.cards
care=whois.nic.care
career=whois.nic.career
cars=whois.nic.cars
casa=whois.nic.casa
case=whois.nic.case
cash=whois.nic.cash
casino=whois.nic.casino
cat=whois.nic.cat
cba=whois.nic.cba
cc=ccwhois.verisign-grs.com
center=whois.nic.center
ceo=whois.nic.ceo
cern=whois.nic.cern
cf=whois.dot.cf
cfa=whois.nic.cfa
cfd=whois.nic.cfd
ch=whois.nic.ch
chanel=whois.nic.chanel
chat=whois.nic.chat
cheap=whois.nic.cheap
chrome=whois.nic.google
church=whois.nic.church
ci=whois.nic.ci
circle=whois.nic.circle
city=whois.nic.city
cl=whois.nic.cl
claims=whois.nic.claims
click=whois.nic.click
clinic=whois.nic.clinic
cloud=whois.nic.cloud
club=whois.nic.club
cn=whois.cnnic.cn
co=whois.nic.co
coach=whois.nic.coach
codes=whois.nic.codes
coffee=whois.nic.coffee
com=whois.verisign-grs.com
comsec=whois.nic.comsec
condos=whois.nic.condos
cool=whois.nic.cool
coop=whois.nic.coop
cpa=whois.nic.cpa
cr=whois.nic.cr
credit=whois.nic.credit
crown=whois.nic.crown
crs=whois.nic.crs
cruise=whois.nic.cruise
cx=whois.nic.cx
cymru=whois.nic.cymru
cyou=whois.nic.cyou
cz=whois.nic.cz
dabur=whois.nic.dabur
dad=whois.nic.google
dance=whois.nic.dance
data=whois.nic.data
date=whois.nic.date
dating=whois.nic.dating
datsun=whois.nic.gmo
day=whois.nic.google
dclk=whois.nic.google
dds=whois.nic.dds
de=whois.denic.de
deal=whois.nic.deal
dealer=whois.nic.dealer
deals=whois.nic.deals
degree=whois.nic.degree
delta=whois.nic.delta
dental=whois.nic.dental
desi=whois.nic.desi
design=whois.nic.design
dev=whois.nic.google
diet=whois.nic.diet
direct=whois.nic.direct
dish=whois.nic.dish
diy=whois.nic.diy
dk=whois.punktum.dk
dm=whois.dmdomains.dm
dnp=whois.nic.dnp
do=whois.nic.do
docs=whois.nic.google
doctor=whois.nic.doctor
dog=whois.nic.dog
dot=whois.nic.dot
drive=whois.nic.google
dtv=whois.nic.dtv
dubai=whois.nic.dubai
dunlop=whois.nic.dunlop
durban=whois.nic.durban
dvag=whois.nic.dvag
dvr=whois.nic.dvr
dz=whois.nic.dz
earth=whois.nic.earth
eat=whois.nic.google
ec=whois.nic.ec
eco=whois.nic.eco
edeka=whois.nic.edeka
edu=whois.educause.edu
ee=whois.tld.ee
email=whois.nic.email
emerck=whois.nic.emerck
energy=whois.nic.energy
epson=whois.nic.epson
erni=whois.nic.erni
es=whois.nic.es
esq=whois.nic.google
eu=whois.eu
eus=whois.nic.eus
events=whois.nic.events
expert=whois.nic.expert
fage=whois.nic.fage
fail=whois.nic.fail
faith=whois.nic.faith
family=whois.nic.family
fan=whois.nic.fan
fans=whois.nic.fans
farm=whois.nic.farm
fast=whois.nic.fast
fedex=whois.nic.fedex
fi=whois.fi
fido=whois.nic.fido
film=whois.nic.film
final=whois.gtlds.nic.br
fire=whois.nic.fire
fish=whois.nic.fish
fit=whois.nic.fit
fj=www.whois.fj
fly=whois.nic.google
fm=whois.nic.fm
fo=whois.nic.fo
foo=whois.nic.google
forex=whois.nic.forex
fox=whois.nic.fox
fr=whois.nic.fr
free=whois.nic.free
frl=whois.nic.frl
fun=whois.nic.fun
fund=whois.nic.fund
futbol=whois.nic.futbol
fyi=whois.nic.fyi
gal=whois.nic.gal
gallo=whois.nic.gallo
gallup=whois.nic.gallup
game=whois.nic.game
games=whois.nic.games
garden=whois.nic.garden
gay=whois.nic.gay
gbiz=whois.nic.google
gd=whois.nic.gd
gdn=whois.nic.gdn
ge=whois.nic.ge
gea=whois.nic.gea
gent=whois.nic.gent
george=whois.nic.george
gf=whois.mediaserv.net
gg=whois.gg
ggee=whois.nic.ggee
gh=whois.nic.gh
gi=whois2.afilias-grs.net
gift=whois.uniregistry.net
gifts=whois.nic.gifts
gives=whois.nic.gives
giving=whois.nic.giving
gl=whois.nic.gl
glass=whois.nic.glass
gle=whois.nic.google
global=whois.nic.global
globo=whois.gtlds.nic.br
gmail=whois.nic.google
gmbh=whois.nic.gmbh
gmo=whois.nic.gmo
gmx=whois.nic.gmx
gn=whois.ande.gov.gn
gold=whois.nic.gold
golf=whois.nic.golf
goo=whois.nic.gmo
goog=whois.nic.google
google=whois.nic.google
gop=whois.nic.gop
got=whois.nic.got
gov=whois.dotgov.gov
gp=whois.nic.gp
gq=whois.dominio.gq
gratis=whois.nic.gratis
green=whois.nic.green
gripe=whois.nic.gripe
group=whois.nic.group
gs=whois.nic.gs
gucci=whois.nic.gucci
guge=whois.nic.google
guide=whois.nic.guide
guru=whois.nic.guru
gy=whois.registry.gy
hair=whois.nic.hair
haus=whois.nic.haus
hdfc=whois.nic.hdfc
help=whois.nic.help
here=whois.nic.google
hermes=whois.nic.hermes
hiphop=whois.nic.hiphop
hiv=whois.nic.hiv
hk=whois.hkirc.hk
hkt=whois.nic.hkt
hm=whois.registry.hm
hn=whois.nic.hn
hockey=whois.nic.hockey
homes=whois.nic.homes
honda=whois.nic.honda
horse=whois.nic.horse
host=whois.nic.host
hot=whois.nic.hot
hotels=whois.nic.hotels
house=whois.nic.house
how=whois.nic.google
hr=whois.dns.hr
ht=whois.nic.ht
hu=whois.nic.hu
hughes=whois.nic.hughes
ibm=whois.nic.ibm
icbc=whois.nic.icbc
ice=whois.nic.ice
icu=whois.nic.icu
id=whois.id
ie=whois.weare.ie
ifm=whois.nic.ifm
ikano=whois.nic.ikano
il=whois.isoc.org.il
im=whois.nic.im
imamat=whois.nic.imamat
imdb=whois.nic.imdb
immo=whois.nic.immo
in=whois.registry.in
inc=whois.nic.inc
info=whois.nic.info
ing=whois.nic.google
ink=whois.nic.ink
insure=whois.nic.insure
int=whois.iana.org
io=whois.nic.io
iq=whois.cmc.iq
ir=whois.nic.ir
irish=whois.nic.irish
is=whois.isnic.is
ist=whois.nic.ist
it=whois.nic.it
itv=whois.nic.itv
jaguar=whois.nic.jaguar
java=whois.nic.java
jcb=whois.nic.gmo
je=whois.je
jeep=whois.nic.jeep
jetzt=whois.nic.jetzt
jio=whois.nic.jio
jll=whois.nic.jll
jobs=whois.nic.jobs
joburg=whois.nic.joburg
jot=whois.nic.jot
joy=whois.nic.joy
jp=whois.jprs.jp
juegos=whois.uniregistry.net
kaufen=whois.nic.kaufen
kddi=whois.nic.kddi
ke=whois.kenic.or.ke
kfh=whois.nic.kfh
kg=whois.kg
ki=whois.nic.ki
kia=whois.nic.kia
kids=whois.nic.kids
kim=whois.nic.kim
kindle=whois.nic.kindle
kiwi=whois.nic.kiwi
kn=whois.nic.kn
koeln=whois.ryce-rsp.com
kosher=whois.nic.kosher
kr=whois.kr
krd=whois.nic.krd
ky=whois.kyregistry.ky
kyoto=whois.nic.kyoto
kz=whois.nic.kz
la=whois.nic.la
lamer=whois.nic.lamer
land=whois.nic.land
lat=whois.nic.lat
latino=whois.nic.latino
law=whois.nic.law
lawyer=whois.nic.lawyer
lb=whois.lbdr.org.lb
lds=whois.nic.lds
lease=whois.nic.lease
lefrak=whois.nic.lefrak
legal=whois.nic.legal
lego=whois.nic.lego
lexus=whois.nic.lexus
lgbt=whois.nic.lgbt
li=whois.nic.li
lidl=whois.nic.lidl
life=whois.nic.life
like=whois.nic.like
limo=whois.nic.limo
link=whois.uniregistry.net
lipsy=whois.nic.lipsy
live=whois.nic.live
llc=whois.nic.llc
llp=whois.nic.llp
loan=whois.nic.loan
loans=whois.nic.loans
locker=whois.nic.locker
locus=whois.nic.locus
lol=whois.nic.lol
london=whois.nic.london
lotte=whois.nic.lotte
lotto=whois.nic.lotto
love=whois.nic.love
lpl=whois.nic.lpl
ls=whois.nic.ls
lt=whois.domreg.lt
ltd=whois.nic.ltd
ltda=whois.nic.ltda
lu=whois.dns.lu
luxe=whois.nic.luxe
luxury=whois.nic.luxury
lv=whois.nic.lv
ly=whois.nic.ly
ma=whois.registre.ma
madrid=whois.nic.madrid
maison=whois.nic.maison
makeup=whois.nic.makeup
man=whois.nic.man
mango=whois.nic.mango
map=whois.nic.google
market=whois.nic.market
mba=whois.nic.mba
md=whois.nic.md
me=whois.nic.me
med=whois.nic.med
media=whois.nic.media
meet=whois.nic.google
meme=whois.nic.google
men=whois.nic.men
menu=whois.nic.menu
mg=whois.nic.mg
miami=whois.nic.miami
mini=whois.nic.mini
mit=whois.nic.mit
mk=whois.marnet.mk
ml=whois.nic.ml
mls=whois.nic.mls
mm=whois.registry.gov.mm
mma=whois.nic.mma
mn=whois.nic.mn
mo=whois.monic.mo
mobi=whois.nic.mobi
mobile=whois.nic.mobile
moda=whois.nic.moda
moe=whois.nic.moe
moi=whois.nic.moi
mom=whois.nic.mom
monash=whois.nic.monash
money=whois.nic.money
mormon=whois.nic.mormon
moscow=whois.nic.moscow
moto=whois.nic.moto
mov=whois.nic.google
movie=whois.nic.movie
mq=whois.mediaserv.net
mr=whois.nic.mr
ms=whois.nic.ms
mtn=whois.nic.mtn
mtr=whois.nic.mtr
mu=whois.nic.mu
museum=whois.nic.museum
music=whois.nic.music
mw=whois.nic.mw
mx=whois.mx
my=whois.mynic.my
mz=whois.nic.mz
na=whois.na-nic.com.na
nab=whois.nic.nab
nagoya=whois.nic.nagoya
name=whois.nic.name
natura=whois.gtlds.nic.br
navy=whois.nic.navy
nc=whois.nc
nec=whois.nic.nec
net=whois.verisign-grs.com
new=whois.nic.google
news=whois.nic.news
next=whois.nic.next
nexus=whois.nic.google
nf=whois.nic.nf
ng=whois.nic.net.ng
ngo=whois.nic.ngo
nhk=whois.nic.nhk
nico=whois.nic.nico
nikon=whois.nic.nikon
ninja=whois.nic.ninja
nissan=whois.nic.gmo
nissay=whois.nic.nissay
nl=whois.domain-registry.nl
no=whois.norid.no
nokia=whois.nic.nokia
norton=whois.nic.norton
now=whois.nic.now
nowruz=whois.nic.nowruz
nowtv=whois.nic.nowtv
nra=whois.nic.nra
nrw=whois.nic.nrw
nu=whois.iis.nu
nyc=whois.nic.nyc
nz=whois.irs.net.nz
obi=whois.nic.obi
olayan=whois.nic.olayan
ollo=whois.nic.ollo
om=whois.registry.om
omega=whois.nic.omega
one=whois.nic.one
ong=whois.nic.ong
onl=whois.nic.onl
online=whois.nic.online
ooo=whois.nic.ooo
open=whois.nic.open
oracle=whois.nic.oracle
orange=whois.nic.orange
org=whois.publicinterestregistry.org
osaka=whois.nic.osaka
otsuka=whois.nic.otsuka
ott=whois.nic.ott
ovh=whois.nic.ovh
page=whois.nic.google
paris=whois.nic.paris
pars=whois.nic.pars
parts=whois.nic.parts
party=whois.nic.party
pay=whois.nic.pay
pccw=whois.nic.pccw
pe=kero.yachay.pe
pet=whois.nic.pet
pf=whois.registry.pf
phd=whois.nic.google
phone=whois.nic.phone
photo=whois.nic.photo
photos=whois.nic.photos
physio=whois.nic.physio
pics=whois.nic.pics
pictet=whois.nic.pictet
pid=whois.nic.pid
pin=whois.nic.pin
ping=whois.nic.ping
pink=whois.nic.pink
pizza=whois.nic.pizza
pk=whois.pknic.net.pk
pl=whois.dns.pl
place=whois.nic.place
play=whois.nic.google
plus=whois.nic.plus
pm=whois.nic.pm
pnc=whois.nic.pnc
pohl=whois.nic.pohl
poker=whois.nic.poker
porn=whois.nic.porn
post=whois.dotpostregistry.net
pr=whois.afilias-srs.net
press=whois.nic.press
prime=whois.nic.prime
pro=whois.nic.pro
prod=whois.nic.google
prof=whois.nic.google
promo=whois.nic.promo
pt=whois.dns.pt
pub=whois.nic.pub
pw=whois.nic.pw
pwc=whois.nic.pwc
qa=whois.registry.qa
qpon=whois.nic.qpon
quebec=whois.nic.quebec
quest=whois.nic.quest
racing=whois.nic.racing
radio=whois.nic.radio
re=whois.nic.re
read=whois.nic.read
realty=whois.nic.realty
red=whois.nic.red
rehab=whois.nic.rehab
reise=whois.nic.reise
reisen=whois.nic.reisen
reit=whois.nic.reit
ren=whois.nic.ren
rent=whois.nic.rent
repair=whois.nic.repair
report=whois.nic.report
rest=whois.nic.rest
review=whois.nic.review
rich=whois.nic.rich
ricoh=whois.nic.ricoh
ril=whois.nic.ril
rio=whois.gtlds.nic.br
rip=whois.nic.rip
ro=whois.rotld.ro
rocks=whois.nic.rocks
rodeo=whois.nic.rodeo
rogers=whois.nic.rogers
room=whois.nic.room
rs=whois.rnids.rs
rsvp=whois.nic.google
ru=whois.tcinet.ru
rugby=whois.nic.rugby
ruhr=whois.nic.ruhr
run=whois.nic.run
rw=whois.ricta.org.rw
rwe=whois.nic.rwe
ryukyu=whois.nic.ryukyu
sa=whois.nic.net.sa
safe=whois.nic.safe
safety=whois.nic.safety
sale=whois.nic.sale
salon=whois.nic.salon
sanofi=whois.nic.sanofi
sap=whois.nic.sap
sarl=whois.nic.sarl
save=whois.nic.save
saxo=whois.nic.saxo
sb=whois.nic.net.sb
sbi=whois.nic.sbi
sbs=whois.nic.sbs
sc=whois2.afilias-grs.net
scb=whois.nic.scb
school=whois.nic.school
schule=whois.nic.schule
scot=whois.nic.scot
se=whois.iis.se
search=whois.nic.google
seat=whois.nic.seat
secure=whois.nic.secure
seek=whois.nic.seek
select=whois.nic.select
seven=whois.nic.seven
sew=whois.nic.sew
sex=whois.nic.sex
sexy=whois.nic.sexy
sfr=whois.nic.sfr
sg=whois.sgnic.sg
sh=whois.nic.sh
sharp=whois.nic.gmo
shaw=whois.afilias-srs.net
shell=whois.nic.shell
shia=whois.nic.shia
shoes=whois.nic.shoes
shop=whois.nic.shop
shouji=whois.teleinfo.cn
show=whois.nic.show
si=whois.register.si
silk=whois.nic.silk
sina=whois.nic.sina
site=whois.nic.site
sk=whois.sk-nic.sk
ski=whois.nic.ski
skin=whois.nic.skin
sky=whois.nic.sky
sling=whois.nic.sling
sm=whois.nic.sm
smart=whois.nic.smart
smile=whois.nic.smile
sn=whois.nic.sn
sncf=whois.nic.sncf
so=whois.nic.so
soccer=whois.nic.soccer
social=whois.nic.social
solar=whois.nic.solar
sony=whois.nic.sony
soy=whois.nic.google
spa=whois.nic.spa
space=whois.nic.space
sport=whois.nic.sport
spot=whois.nic.spot
srl=whois.nic.srl
ss=whois.nic.ss
st=whois.nic.st
stada=whois.nic.stada
star=whois.nic.star
stc=whois.nic.stc
store=whois.nic.store
stream=whois.nic.stream
studio=whois.nic.studio
study=whois.nic.study
style=whois.nic.style
su=whois.tcinet.ru
sucks=whois.nic.sucks
supply=whois.nic.supply
surf=whois.nic.surf
suzuki=whois.nic.suzuki
swatch=whois.nic.swatch
swiss=whois.nic.swiss
sx=whois.sx
sy=whois.tld.sy
sydney=whois.nic.sydney
tab=whois.nic.tab
taipei=whois.nic.taipei
talk=whois.nic.talk
taobao=whois.nic.taobao
tatar=whois.nic.tatar
tattoo=whois.nic.tattoo
tax=whois.nic.tax
taxi=whois.nic.taxi
tc=whois.nic.tc
tci=whois.nic.tci
td=whois.nic.td
tdk=whois.nic.tdk
team=whois.nic.team
tech=whois.nic.tech
tel=whois.nic.tel
tennis=whois.nic.tennis
teva=whois.nic.teva
tf=whois.nic.tf
tg=whois.nic.tg
th=whois.thnic.co.th
thd=whois.nic.thd
tiaa=whois.nic.tiaa
tienda=whois.nic.tienda
tips=whois.nic.tips
tires=whois.nic.tires
tirol=whois.nic.tirol
tk=whois.dot.tk
tl=whois.nic.tl
tm=whois.nic.tm
tmall=whois.nic.tmall
tn=whois.ati.tn
to=whois.tonic.to
today=whois.nic.today
tokyo=whois.nic.tokyo
tools=whois.nic.tools
top=whois.nic.top
toray=whois.nic.toray
total=whois.nic.total
tours=whois.nic.tours
town=whois.nic.town
toyota=whois.nic.toyota
toys=whois.nic.toys
tr=whois.trabis.gov.tr
trade=whois.nic.trade
travel=whois.nic.travel
trust=whois.nic.trust
trv=whois.nic.trv
tube=whois.nic.tube
tui=whois.nic.tui
tunes=whois.nic.tunes
tushu=whois.nic.tushu
tv=whois.nic.tv
tvs=whois.nic.tvs
tw=whois.twnic.net.tw
tz=whois.tznic.or.tz
ua=whois.ua
ubank=whois.nic.ubank
ubs=whois.nic.ubs
ug=whois.co.ug
uk=whois.nic.uk
unicom=whois.nic.unicom
uno=whois.nic.uno
uol=whois.gtlds.nic.br
ups=whois.nic.ups
us=whois.nic.us
uy=whois.nic.org.uy
uz=whois.cctld.uz
vana=whois.nic.vana
vc=whois2.afilias-grs.net
ve=whois.nic.ve
vegas=whois.nic.vegas
vet=whois.nic.vet
vg=whois.nic.vg
viajes=whois.nic.viajes
video=whois.nic.video
vig=whois.nic.vig
viking=whois.nic.viking
villas=whois.nic.villas
vin=whois.nic.vin
vip=whois.nic.vip
virgin=whois.nic.virgin
visa=whois.nic.visa
vision=whois.nic.vision
viva=whois.nic.viva
vodka=whois.nic.vodka
volvo=whois.nic.volvo
vote=whois.nic.vote
voting=whois.nic.voting
voto=whois.nic.voto
voyage=whois.nic.voyage
vu=whois.dnrs.vu
wales=whois.nic.wales
walter=whois.nic.walter
wang=whois.gtld.knet.cn
watch=whois.nic.watch
webcam=whois.nic.webcam
weber=whois.nic.weber
wed=whois.nic.wed
weibo=whois.nic.weibo
weir=whois.nic.weir
wf=whois.nic.wf
wien=whois.nic.wien
wiki=whois.nic.wiki
win=whois.nic.win
wine=whois.nic.wine
wme=whois.nic.wme
work=whois.nic.work
works=whois.nic.works
world=whois.nic.world
wow=whois.nic.wow
ws=whois.website.ws
wtc=whois.nic.wtc
wtf=whois.nic.wtf
xerox=whois.nic.xerox
xihuan=whois.teleinfo.cn
xin=whois.nic.xin
xxx=whois.nic.xxx
xyz=whois.nic.xyz
yachts=whois.nic.yachts
ye=whois.y.net.ye
yoga=whois.nic.yoga
you=whois.nic.you
yt=whois.nic.yt
yun=whois.teleinfo.cn
zappos=whois.nic.zappos
zara=whois.nic.zara
zip=whois.nic.google
zm=whois.zicta.zm
zone=whois.nic.zone
